a - а
b - б
v - в
g - г
d - д
e - е
yo - ё
zj - ж
zh - ж
z - з
i - и
y - й
k - к
l - л
m - м
n - н
o - о
p - п
r - р
s - с
t - т
u - у
f - ф
h - х
ts - ц
c - ц
ch - ч
sh - ш
sch - щ
i - ы
' - ь
e - э
yu - ю
ya - я
iye - ие
tsa - тся
tsya - тся
chiy - чий
chiya - чия
niya - ния

etika - этика
obshee - общее
noviy - новый
effekt - эффект
navik - навык
ob'yekt - объект
viigral - выйграл
bit - быт